11111111111111111111111111111
10000000000000000000000000001
10000000010001000010000000001
10001000010010100010000000001
10000000010001000010000000001
10000000010000000010000000001
10000000000000000000000000001
10000010000000000000000000001
10000110100000000000000000001
10000001000000100000110000001
100000000000001100001 1000001
10000000000000100000111000001
10000000000000000000000000001
10000000000000000000000000001
11111111111111111111111111111