NO ./textures_copy/test/north.xpm
SO ./textures_copy/test/south.xpm
WE ./textures_copy/test/west.xpm
EA ./textures_copy/test/east.xpm

F 255, 188, 98
C 98, 179, 255

        1111111111111111111111111
        1000000000110000000000001
        1011000001110000001000001
        1001000000000000000000001
111111111011000001110000000000001
100000000000000001110111111111111
111101100000110111000000100011111
111101101100110111010100100011111
110000000101010111000000100011111
10000000N000000011000000100011111
100000000000000011010100100011111
110000011101010111110111100011111
11110111 1110101 1011110100011111
11111111 1111111 1111111111111111
