NO ./north.xpm        
SO          ./south.xpm
WE ./west.xpm
EA ./east.xpm
F             
C 225,30,110
11111111112111111111111111111111
100N0000000000000000000000000001
10000000000000000000000000000001
11111111111101111111111111111111
           101
11111111111101111111111111111111
10000000000000000000000000000001
11111111111111111111111111111111