NO ./tmp_files/north.xpm        
SO ./tmp_files/south.xpm
WE ./tmp_files/west.xpm
EA ./tmp_files/east.xpm

F  10,1,0 
C 225,30,110

11111111111111111111111111111111
100N0000000000000000000000000001
10000000000000000000000000000001
11111111111101111111111111111111
           101
111111111111011111111111111111111111
10000000000000000000000000000001
11111111111111111111111111111111





