NO ./north.xpm
SO ./south.xpm
WE ./west.xpm
EA ./east.xpm

F 220,100,0
C 225,30,110

11111111111111111111111111111
10000000000000000011000000001
10000000001100000111000000001
10000000000100000000000000001
11111111101100000111000000001
10000000001100000111011111111
11110111111111011100000010001
11111111111111111111111111111
