1111111111111111111111111
1000000010000000001000001
1110001101111101100100011
1110000011101000111100001
1110000000000000000000001
1000000000000000000000001
1000000000011011011000001
1111111111111111111111111