1111111111111111111111111111111111111
1000000010000000001000000011001100101
1110001101111101100100010111001100011
1110000011101000111100000010010010011
1110000000000000000000000001011010101
1000000000000000000000000000000000001
1000000000011011011000001010001000101
1111111111111111111111111111111111111