NO ./textures/img/metal_1.xpm
SO ./textures/img/elevator.xpm
WE ./textures/img/metal_2.xpm
EA ./textures/img/metal_3.xpm


C 255,255,255
F 0, 0, 0

11111111111111111   11111
10000000000000001   10001
10000000000000001   10001
1000000000000000111110001
1000000000000000000000001
1000000011000110000000001
1000000011001001000000001
1000000000000110000010001
1000000000000000000110001
1000000000000000001110001
1000000000000000011110001
1000000000100000001110001
1000000000100000000110001
1000000010000000000010001
1000000000000000000000001
1000000000000000N00000001
1000000000111000000000001
1000000000110000000000001
1000000000100000000000001
11111000000000000000000011111
    1000000000000000000000001
11111000000000000000000011111
1000000000000000000000001
1000000000000000000000001
1111111111111111111111111
