11111111111111111111111111111
10000010001100000010000100101
10110010011100000010000010101
10010000000000100000000000001
11011001101100000111000001001
10000000001101100111010010001
10010000001100000111010000001
11111111111111111111111111111