NO ./textures/img/metal_1.xpm
SO ./textures/img/elevator.xpm
WE ./textures/img/metal_2.xpm
EA ./textures/img/metal_3.xpm


F 220,100,0
C 225,30,0


        1111111111111111111111111
        1000000000110000000000001
        1011000001110000000000001
        1001000000000000000000001
111111111011000001110000000000001
100000000011000001110111111111111
111101111111110111000000100010001
11110111111111011101010010001001
11000000110101011100000010000001
10000000000000001100000000001001
10000000000000001101010000001001
11000001110101011111001110N0111
11110111 1100001 10111101000101
11111111 1111111 1111111111111
